アケビタウン	akebi taun
アサツキタウン	asatsuki taun
アスチルベタウン	asuchirubetaun
アベリアタウン	aberia taun
アラモスタウン	aramosutaun
アルケーの谷	arukē no tani
アルトマーレ	arutomāre
イーストイッシュ	īsutoisshu
イーブイハウス	ībuihausu
イザベ島	izabe tō
オルドラン城	jō
鏡の国	kagami no kuni
かくれ里	kakure sato
カジノキシティ	kajinoki shiti
風の駅	kaze no eki
カタクリタウン	katakuri taun
カレントタウン	karento taun
グリーンフィールド	gurīn fīrudo
グロリオシティ	gurorioshiti
グンジョウシティ	gunjōshiti
時空の塔	jikū no tō
ジョウチャンタウン	jōchantaun
ジルバタウン	jiruba taun
白の遺跡	shiro no iseki
スイレンタウン	suiren taun
スズラン島	suzuran tō
世界のはじまりの樹	sekai no hajimari no ki
大地の剣	daichi no ken
タツナミタウン	tatsunamitaun
チカクノタウン	chikakunotaun
テーブルマウンテン	tēburu maunten
デセルシティ	deserushiti
デセルタワー	deserutawā
テッシード研究所	tesshīdo kenkyūjo
トアルタウン	toarutaun
トネリコタウン	toneriko taun
ニューアイランド	nyūairando
ハテノの森	hateno no mori
反転世界	hanten sekai
ヒガキシティ	higakishiti
ピュアズロック	pyuazurokku
ビンヌ	binnu
ファウンス	faunsu
フレイシティ	furei shiti
ポケモンスクール	pokemonsukūru
ポケモンゼミナール	pokemonzemināru
マッチャシティ	macchashiti
ミチーナ	michīna
ミチーナ神殿	michīna shinden
ミリーファタウン	mirīfataun
ミロス島	mi rosu tō
モダマタウン	modamataun
ユズリハ島	yuzuriha tō
ラーグンタウン	rāguntaun
ライモンタウン	raimontaun
ラルース	rarūsu
リザフィックバレー	rizafikkubarē
竜の里	ryū no sato
竜の谷	ryū no tani
ルイボスタウン	ruibosutaun
ロータ	rōta
マサラタウン	masarataun
トキワシティ	tokiwa shiti
ニビシティ	nibishiti
ハナダシティ	hanadashiti
クチバシティ	kuchibashiti
シオンタウン	shion taun
タマムシシティ	tamamushi shiti
ヤマブキシティ	yamabuki shiti
セキチクシティ	sekichiku shiti
グレンタウングレンじま	ji ma
セキエイこうげん	seki ei kō gen
トキワのもり	tokiwa no mori
おつきみやま	otsuki miyama
ディグダのあな	diguda no ana
ハナダのどうくつ	hanada no dō kutsu
イワヤマトンネル	iwayamatonneru
むじんはつでんしょ	mujinhatsudensho
シルフカンパニー	shirufukanpanī
ポケモンタワー	pokemontawā
ふたごじま	futa goji ma
ポケモンやしき	pokemon ya shiki
グレンラボラトリー	guren rabora torī
みさきのこや	mi sa kinoko ya
トージョウのたき	tōjō no taki
ワカバタウン	wakabataun
ヨシノシティ	yoshino shiti
キキョウシティ	kikyō shiti
ヒワダタウン	hiwadataun
コガネシティ	kogane shiti
エンジュシティ	enju shiti
アサギシティ	asagishiti
タンバシティ	tanbashiti
チョウジタウン	chōji taun
フスベシティ	fusubeshiti
くらやみのほらあな	kura yami no hora ana
マダツボミのとう	madatsubomi no tō
アルフのいせき	arufu no iseki
つながりのどうくつ	tsunagari no dō kutsu
ヤドンのいど	yadon noido
ウバメのもり	ubame no mori
ラジオとう	rajio tō
しぜんこうえん	shi zen kōen
スズのとう	suzu no tō
やけたとう	yake tatō
モーモーぼくじょう	mō mō bokuji yō
かがやきのとうだい	kagayaki no tō dai
スリバチやま	suribachi ya ma
いかりのみずうみ	ikari nomizu umi
うずまきじま	uzumakiji ma
こおりのぬけみち	kōri no nukemichi
りゅうのあな	ryū no ana
シロガネやま	shirogane ya ma
ミシロタウン	mishirotaun
コトキタウン	kotokitaun
トウカシティ	tōkashiti
カナズミシティ	kanazumishiti
ムロタウン	murotaun
カイナシティ	kainashiti
キンセツシティ	kinsetsushiti
シダケタウン	shidaketaun
フエンタウン	fuentaun
ヒワマキシティ	hiwamakishiti
ハジツゲタウン	haji tsuge taun
ミナモシティ	minamoshiti
トクサネシティ	tokusaneshiti
ルネシティ	runeshiti
キナギタウン	kinagitaun
サイユウシティ	saiyūshiti
トウカのもり	tōka no mori
カナシダトンネル	kanashidatonneru
こじまのよこあな	koji ma noyo ko ana
いしのどうくつ	ishi no dō kutsu
すてられぶね	suterare bune
シーキンセツ	shīkinsetsu
カラクリやしき	karakuri ya shiki
げんえいのとう	gen ei no tō
さばくいせき	saba kui seki
ほのおのぬけみち	ho no ono nukemichi
えんとつやま	ento tsuya ma
デコボコさんどう	dekoboko san dō
さばくのちかどう	sabaku nochi ka dō
りゅうせいのたき	ryū sei no taki
こだいづか	koda izu ka
おくりびやま	okuri biyama
あさせのほらあな	a sase no hora ana
かいていどうくつ	kaitei dō kutsu
めざめのほこら	mezame no hokora
マボロシじま	ji ma
そらのはしら	sora no hashira
おふれのせきしつ	o fure no seki shitsu
バトルタワー	batoru tawā
バトルフロンティア	batoru furontia
へんげのどうくつ	henge no dō kutsu
バトルリゾート	batoru rizōto
りくのどうくつ	riku no dō kutsu
うみのどうくつ	umi no dō kutsu
ひでりのいわと	hideri no iwa to
みなみのことう	minami no kotō
トレーナーヒル	torēnā hiru
さいはてのことう	sai hate no kotō
1のしま	1 no shima
2のしま	2 no shima
3のしま	3 no shima
4のしま	4 no shima
5のしま	5 no shima
6のしま	6 no shima
7のしま	7 no shima
ほてりのみち	hoteri no michi takara no hama
たからのはま	kiwa no misaki
きわのみさき	3 no shima minato
3のしま みなと	kizunaba shi
きずなばし	5 no shima a kichi
5のしま あきち	omoide no tō
おもいでのとう	mizu nomeiro
みずのめいろ	gōjasu rizōto
ゴージャスリゾート	mizu no sanpomichi
みずのさんぽみち	midori no sanpomichi
みどりのさんぽみち	hazure no shima
はずれのしま	iseki nota ni
いせきのたに	torēnā tawā
トレーナータワー	keiko kuiri guchi
けいこくいりぐち	shi ppō kei koku
しっぽうけいこく	asukana iseki
アスカナいせき	tomoshi biyama
ともしびやま	3 no shimayo ko ana
3のしま よこあな	ki nomi no mori
きのみのもり	ite daki no dō kutsu
いてだきのどうくつ	kaerazu no ana
かえらずのあな	shirushi no hayashi
しるしのはやし	henge no dō kutsu
へんげのどうくつ	ten no ana
てんのあな	asukana no kagi
アスカナのかぎ	asukana no seki shitsu
アスカナのせきしつ	iresu no seki shitsu
イレスのせきしつ	nazan no seki shitsu
ナザンのせきしつ	yugo no seki shitsu
ユゴのせきしつ	areboka no seki shitsu
アレボカのせきしつ	kotō no seki shitsu
コトーのせきしつ	anuza no seki shitsu
アヌザのせきしつ	orifu no seki shitsu
オリフのせきしつ	pokemonnettowākusentā
ポケモンネットワークセンター	tomoshi bionsen
ともしびおんせん	rokettoda n sō ko
ロケットだんそうこ	e sono iwa
へそのいわ	tanjō no shima
たんじょうのしま	futaba taun
フタバタウン	masagotaun
マサゴタウン	kotobuki shiti
コトブキシティ	kuroganeshiti
クロガネシティ	sonōtaun
ソノオタウン	hakutaishiti
ハクタイシティ	yosugashiti
ヨスガシティ	zui taun
ズイタウン	nomoseshiti
ノモセシティ	tobarishiti
トバリシティ	kannagitaun
カンナギタウン	mioshiti
ミオシティ	kissakishiti
キッサキシティ	nagisashiti
ナギサシティ	faito eria
ファイトエリア	sabaibaru eria
サバイバルエリア	rizōto eria
リゾートエリア	shinji ko
シンジこ	kuroganegēto
クロガネゲート	kurogane tan kō
クロガネたんこう	areta nukemichi
あれたぬけみち	sonō no hanaba take ta ni ma no hatsu den sho
ソノオのはなばたけ	haku tai no mori
たにまのはつでんしょ	mori no yō kan
ハクタイのもり	mayoi no dō kutsu
もりのようかん	ten gan zan
まよいのどうくつ	fureai hiroba
テンガンざん	rosuto tawā
ふれあいひろば	zui no iseki
ロストタワー	mania tonneru
ズイのいせき	jiman no ura niwa
マニアトンネル	daishi tsugen
じまんのうらにわ	risshi ko
だいしつげん	tatara sei tetsuji yo
リッシこ	kō tetsuji ma
タタラせいてつじょ	eichi ko
こうてつじま	yari no hashira
エイチこ	paru pāku
やりのはしら	kis saki shin den
パルパーク	hādo maunten
キッサキしんでん	kakure izumi e no michi
ハードマウンテン	o kuri no izumi
かくれいずみへのみち	modori no dō kutsu
おくりのいずみ	ma ngetsuji ma
もどりのどうくつ	shingetsuji ma
まんげつじま	umi ware no michi
しんげつじま	wa nanora kuen
うみわれのみち	yabureta sekai
はなのらくえん	hamanasu pāku
やぶれたせかい	kanokotaun
ハマナスパーク	karakusataun
カノコタウン	sanyōshiti
カラクサタウン	shippōshiti
サンヨウシティ	hiunshiti
シッポウシティ	raimonshiti
ヒウンシティ	hodomoeshiti
ライモンシティ	fukiyoseshiti
ホドモエシティ	sekkashiti
フキヨセシティ	sōryūshiti
セッカシティ	kagome taun
ソウリュウシティ	sazanamitaun
カゴメタウン	burakku shiti
サザナミタウン	howaitoforesuto
ブラックシティ	kanawataun
ホワイトフォレスト	hiōgi shiti
カナワタウン	sangi taun
ヒオウギシティ	tachiwakishiti
サンギタウン	yamajitaun
タチワキシティ	seigaihashiti
ヤマジタウン	P 2 rabo
セイガイハシティ	yume no a tochi
P2ラボ	chika sui myaku no ana
ゆめのあとち	yaguruma no mori
ちかすいみゃくのあな	shi saku no hara
ヤグルマのもり	rizōto dezāto
しさくのはら	ko dai no shiro
リゾートデザート	rei tō kontena
こだいのしろ	den kīshi no hora ana
れいとうコンテナ	fukiyose no hora ana
でんきいしのほらあな	tawāobuhebun
フキヨセのほらあな	neji ya ma
タワーオブヘブン	ryūrasen no tō
ネジやま	sekka no shi tsugen
リュウラセンのとう	shi yugyōnoiwaya
セッカのしつげん	N no shiro
しゅぎょうのいわや	jaiantohōru
Nのしろ	sazanami wan
ジャイアントホール	kaite ī seki
サザナミわん	hōjō no yashiro
かいていいせき	mayoi no mori
ほうじょうのやしろ	ribatigāden tō
まよいのもり	chikai no hayashi
リバティガーデンとう	sangi bokuji yō
ちかいのはやし	tachiwakikonbināto
サンギぼくじょう	ge sui dō
タチワキコンビナート	ko dai no nukemichi
ヒウンげすいどう	ribāsumaunten
こだいのぬけみち	sutorenjāhausu
リバースマウンテン	umibe no dōketsu
ストレンジャーハウス	purazumafurigēto
うみべのどうけつ	kokoro no kū dō
プラズマフリゲート	yākonrōdo
こころのくうどう	asametaun
ヤーコンロード	meisuitaun
アサメタウン	hakudanshiti
メイスイタウン	miareshiti
ハクダンシティ	kobokutaun
ミアレシティ	shōyōshiti
コボクタウン	seki tai taun
ショウヨウシティ	shara shiti
セキタイタウン	hiyokushiti
シャラシティ	kunoeshiti
ヒヨクシティ	fūjotaun
クノエシティ	hyakkokushiti
フウジョタウン	renritaun
ヒャッコクシティ	eisetsushiti
レンリタウン	kinanshiti
エイセツシティ	haku dan no mori
キナンシティ	jitsuna ginodōketsu
ハクダンのもり	kagayaki no dō kutsu
じつなぎのどうけつ	utsu shimi no dō kutsu
かがやきのどうくつ	wadatsumi no ana
うつしみのどうくつ	are hate hoteru
わだつみのあな	furosutokeibu
あれはてホテル	pokemon no mura
フロストケイブ	utsuro no ma
ポケモンのむら	tsui no dō kutsu na nashi no dō kutsu
うつろのま	hauorishiti
ついのどうくつ	rirītaun
ななしのどうくつ	kantaishiti
ハウオリシティ	ohanataun
リリィタウン	konikoshiti
カンタイシティ	marieshiti
オハナタウン	pō taun
コニコシティ	kapu no mura
マリエシティ	umi no tami no mura
ポータウン	roiyaru abenyū
カプのむら	harontaun
うみのたみのむら	burasshītaun
ロイヤルアベニュー	enjin shiti
ハロンタウン	tāfutaun
ブラッシータウン	bautaun
エンジンシティ	nakkuru shiti
ターフタウン	raterarutaun
バウタウン	arabesuku taun
ナックルシティ	kirukusutaun
ラテラルタウン	supaiku taun
アラベスクタウン	shūto shiti
キルクスタウン	madoromi no mori
スパイクタウン	gararu kō zan
シュートシティ	dai ni kō zan
まどろみのもり	ruminasumeizu no mori
ガラルこうざん	kotobuki mura
だいにこうざん	kuro 曜 no genya
ルミナスメイズのもり	guren no shicchi
コトブキムラ	gunjō no kaigan
黒曜の原野	ten kanmuri no sanroku
紅蓮の湿地	junpaku no tōdo
群青の海岸	taishizaka
天冠の山麓	teitetsu ヶ hara
純白の凍土	ensei no kaikonchi
大志坂	shishi no sandō
蹄鉄ヶ原	shishi no takadai
園生の開墾地	morinodaisho
シシの山道	kaze nukemichi
シシの高台	kezurarekyō
森の台所	kakō no entei
風抜け道	oku no mori
削られ橋	kyoboku no senjō
河口の堰堤	kuro tetsu tonneru
奥の森	kuro 曜 no taki
巨木の戦場	kewashi hayashi
黒鉄トンネル	masago heigen
黒曜の滝	shinji ko
険し林	shinji ko no kūdō
マサゴ平原	hamanasu no shima
シンジ湖	kiniro no heiya
シンジ湖の空洞	zui no iseki
ハマナスの島	ōguchi no numa
金色の平野	hedoro daichi
ズイの遺跡	shinkunuma
大口の沼	kuma no keikojō
ヘドロ台地	gorogoro saka
深紅沼	kongo u shūraku
クマの稽古場	kongo u no satoyama
ゴロゴロ坂	unkaitōge
コンゴウ集落	risshi ko
コンゴウの里山	risshi ko no kūdō
雲海峠	kiri no iseki
リッシ湖	butai no senjō
リッシ湖の空洞	keyari no sōgen
霧の遺跡	haoto no hara
舞台の戦場	shiren no nakasu
毛槍の草原	ichō no hamabe
羽音の原	watari no nazoe
試練の中州	maigo no isobe
イチョウの浜辺	kaze sarashi no mori
渡りのなぞえ	tobari misaki
迷子の磯辺	eipamu san
風さらしの森	susuki no ie
帳岬	uranohama
エイパム山	mizuabi kata
ススキの家	obake wara
浦の浜	suna no te
水浴び潟	tonbo rodō
オバケワラ	shizukana uchiumi
砂の手	dai sakana no kakure iwa
トンボロ道	kaisō no rakuen
静かな内海	shio no nukemichi
大魚の隠れ岩	umibe no shō ana
海草の楽園	hi fuki shima
潮の抜け道	yōgan no senjō
海辺の小穴	kakō no hokora
火吹き島	shimanami hama
溶岩の戦場	kakure izumi e no michi
火口の祠	modori no dōkutsu
しまなみ浜	shinzen no takadai
隠れ泉への道	mayoi no dōkutsu
戻りの洞窟	mayoi no sanrin
神前の高台	kodai no ishigirijō
迷いの洞窟	junreisha no michi
迷いの山林	hanare yūsui
古代の石切り場	kaminagi sandō
巡礼者の道	gorogoro sanchi
離れ湧水	ressekitōge
カミナギ山道	fearī no izumi
ゴロゴロ山地	gake nobori gake
列石峠	kaminagi jīn ato
フェアリーの泉	taiko no horāna
崖登り崖	inori no hiroba
カミナギ寺院跡	mukai tsuki no senjō
太古の洞穴	ryū kumo no kiridōshi
祈りの広場	iwa no mon
迎月の戦場	shinō shinden
笠雲の切り通し	gō yukitani
岩の門	gokkan no arechi
シンオウ神殿	hyōzan no chikadō
豪雪谷	kurebēsu hyōkai
極寒の荒地	shinju shūraku
氷山の地下道	himitsu no yokoana
クレベース氷塊	hyōga no dankyū
シンジュ集落	eichi ko
秘密の横穴	eichi ko no kūdō
氷河の段丘	kis saki shinden
エイチ湖	yukimi no shutsu de yu
エイチ湖の空洞	senjō e no michi
キッサキ神殿	hyōzan no senjō
雪見の出で湯	kokorogata iwayama
戦場への道	kurebasu no nukemichi
氷山の戦場	fuyu komori no horāna
心形岩山	oni kōri taki
クレバスの抜け道	tsurara no ma
冬籠りの洞穴	nadarezaka
鬼氷滝	kosajitaun
氷柱の間	puratotaun
雪崩坂	tēburu shiti
コサジタウン	serukurutaun
プラトタウン	bōru taun
テーブルシティ	hakkōshiti
セルクルタウン	karafushiti
ボウルタウン	marinādotaun
ハッコウシティ	pike taun
カラフシティ	chanpurutaun
マリナードタウン	furijjitaun
ピケタウン	beikutaun
チャンプルタウン	kosaji no komichi
フリッジタウン	irie no horāna
ベイクタウン	rōsuto sabaku
コサジの小道	shirushi no ki tachi
入り江のほら穴	purupike sandō
ロースト砂漠	nappe san
しるしの木立ち	beiku kūdō
プルピケ山道	ō ja no mizūmi
ナッペ山	okoge rindō
ベイク空洞	parudea no ōana
オージャの湖	eria zero
オコゲ林道	zero gēto
パルデアの大穴	zero rabo
エリアゼロ	chīmu segin no ajito
ゼロゲート	chīmu shedaru no ajito
ゼロラボ	chīmu shī no ajito
チーム・セギンのアジト	chīmu rukubā no ajito
チーム・シェダルのアジト	chīmu kāfu no ajito
チーム・シーのアジト	suiryokutaun
チーム・ルクバーのアジト	kitakami kaidō
チーム・カーフのアジト	appuruhiruzu
スイリョクタウン	maide sandō
キタカミ街道	fuji ga hara
アップルヒルズ	rakudo no arechi
舞出山道	oni ga yama
フジが原	oniba kūdō
楽土の荒地	osore ana
鬼が山	jigogudani
鬼歯空洞	terasu ike
恐れ穴	hiyamizu hora
地獄谷	ochiai kawara
てらす池	onikaku kyōkoku
ひやみず洞	kitakami gensei chīki
落合川原	tokoshie no mori
鬼角峡谷	tomokko puraza
キタカミ原生地域	kitakamisentā
とこしえの森
ともっこプラザ
キタカミセンター